50x24
#################################################
#OOO                 ##            ##         OO#
#OOO                 ##            ##     S   OO#
#        OOO ##             ##               OOO#
#        OOO ##             ##          OOOOOOOO#
#      ##########################################
#      ##########################################
#                OO##OOOOOOOOOOOOOOOOOOOOOOOOOOO#
#                OO##OOO   OOOOOOOOOOOOOOOOOOOOO#
#OOO      ##       ##OOO F                      #
#OOO      ##       ##OOO   OOOOOOOOOOOOOOOO   OO#
############       ##OOOOOOOOOOOOOOOOOOOOOO   OO#
#OO                ##         #                 #
#OO                ##                 #         #
#      ##      OOOO##    OOOOOOOOOOOOOOOOOOOOOOO#
#      ##      OOOO##    OOOOOOOOOOOOOOOOOOOOOOO#
#  OOOO##############                    ########
#  OOOO##############     ##     ##           OO#
#      ##OO      OO##     ##     ##           OO#
#OOOO  ##OO        ########################     #
#OOOO  ##     ##          OO      OO  OOOOO     #
#####       OO##      OO      OO      OOOOO   OO#
#           OO##          OO      OO          OO#
#################################################
